111111111
100500091
101010101
100000201
101010101
100200201
101010101
100000001
101010101
120200001
101010101
120200201
101210101
120000001
101010101
120200001
101210101
120000201
111111111