111111111111111111111111111111111111111
1000000c0000000000000000000000000000001
101010101010121010101010121010101010101
100000200000020022020202020202020202021
101010101010101010101010101010101010101
100200202000000000000000000000000000001
101010101010121010101010121010101010101
100000002000000020000000000000000000001
101010101010101010101010101010101010101
120200002000020000000020020000000000001
101010101010101010101010101010101010101
120200200000020000000000020000000000001
101210101010101010101010101010101010101
120000002000000000000020000000000000001
101010101010121010101010121010101010101
120200002000002000000020000000000000001
101210101010101010101010101010101010101
120000202000020000000020020000000000001
101010101010121010101010121010101010101
111111111111111111111111111111111111111
