111111111111111111111111111
100020060002002000002100001
101012101012121010101010101
100220202029020022020022021
101012101010101010101010101
120200202000000000000000001
101010101010121010101010101
100000002000000020000020001
101010101010101010101010101
120200002000020000000000001
101010101010101010101010101
120200200000020000000000001
101210101010101010101010101
120000002000000000000000001
101010101010121010101010101
120200002000002000002000001
101210101010101010101010101
120000202000020000000000001
101010101010121010101010101
111111111111111111111111111
