111111111111111111111
100020060002002022221
101212121012121010121
122220202020020022001
101012101010101010101
120200202000000000001
101010101010121010101
100000009000000020001
111111111111111111111
